NO                                            tex/NO.png
    SO        tex/SO.png









WE	 tex/WE.png

                                     EA                                                                                                                                      tex/EA.png
F                     0,0,0
         C 0,0,255

























111111111111111111111111
100000000000000000000001
100000000000000000000001
100000000000000000000001
100000111110000101010001
100000100010000000000001
100000100010000100010001
100000100010000000000001
100000110110000101010001
100000000000000000000001
100000000000000000000001
100000000000000000000001
100000000000000000000001
100000000000N00000000001
100000000000000000000001
100000000000000000000001
111111111000000000000001
110100001000000000000001
110000101000000010000001
110100001000000101000001
110111111000000010000001
110000000000000000000001
111111111000000000000001
111111111111111111111111
