NO ./test.png
SO ./SO.png
WE ./WE.png
EA ./EA.png
F 220,100,0
C 225,30,0
11111111
10000001
100000S1
10000001
10000001
10100001
10000001
11111111