NO tex/NO.png
SO tex/SO.png
C 0,30,0
WE tex/WE.png
EA tex/EA.png
F 220,10,366




111111111111
100000000001
10000S000001
100001000001
100001011111
100001011111
111100011111
111100011111
111100011111
111100011111
  111111
